SO ./textures/deneme0.xpm
WE ./textures/beer.xpm
EA ./textures/deneme2.xpm
NO ./textures/deneme3.xpm

F 0,0,0
C 255,255,255

1111111111111111111111111111111111111
1111111111111111111111111111111111111
1111111111111111111111111111111111111
1111111111111111111111111111111111101 
1000100100011111111111111111111111101
1100000000011111111111111111111111101
1000000000011111111111111111111111101
1111100111111111111111111111111111101
 111100111111111111111111111111111101
1111100101010101010101010101010101101
1E00000000000000000000000000000000001
1111111111111111111111111111111111111
1111111111111111 11111111111111111111
