NO ./textures/deneme0.xpm
SO ./textures/deneme1.xpm
WE ./textures/deneme2.xpm
EA ./textures/deneme3.xpm

F 220,100,0
C 225,30,0


111111111111111111
101000000000000001
101000000000000001
101000000000000001
101000000000000001
100000000000N00001
100000000000000001
100000100000000001
100000100000000001
111111111111111111
