NO ./textures/deneme1.xpm
SO ./textures/deneme1.xpm
WE ./textures/deneme1.xpm
EA ./textures/deneme1.xpm

F 220,100,30
C 225,30,50


11111
100011111111111111111
100000000000000000001
100N11111111111111111
11111
