SO ./textures/deneme0.xpm
WE ./textures/deneme1.xpm
EA ./textures/deneme2.xpm
NO ./textures/deneme3.xpm

F 220,100,30
C 225,30,50



1111111111111111
1000000000000001
1000000000000001
1000000000000001
1000000000000001
1000000000000001
1000000000000001
1000000000000001
1000000000000001
1000000000000001
1000000000000001
1000000000000001
1000000000000001
1000000000000001
1000000000000001
1000000000000001
1000000000000001
1000000000000001
1000000000000001
1000000000000001
1000000000000000111111111111
1000000000000001
1000000000000001
1000000000000001
1000000000000001
1000000010000001
1000000000000001
1000000000000001
1000N00000000001
1000001000000001
1000000000000001
1111111111111111
