NO ./textures/deneme0.xpm
SO ./textures/deneme1.xpm
WE ./textures/deneme2.xpm
EA ./textures/deneme3.xpm

F 220,100,0
C 225,30,0




        11111111111111111111111111
        1000000000110000000000001
        1011000001110000000000001
        1001000000000000000000001
111111111011000001110000000000001
100000000011000001110111110111111
11110111111111011100000010001
11110111111111011101000010001
11000000110101011100000010001
100000000N0000001100000010001
100000000000000110101001001
1100000111010101111101110011
1111011111111011111111010001
11111 11 1111111111 1111111111
