SO ./textures/beer.xpm
WE ./textures/4k.xpm
EA ./textures/beer.xpm
NO ./textures/beer.xpm

F 0,0,0
C 255,255,255



1111111111111
1000000000001
1000000000001
1000000000001
1000W00011111
1000000000001
1000000000001
1111111111111
