SO ./textures/beer.xpm
WE ./textures/4k.xpm
EA ./textures/beer.xpm
NO ./textures/beer.xpm

F 12,12,21
C  255,255,255



111111111111111111111 1111
10000000100011111111111111
10000000000011
1000000000001
1000W00011111
1000000000001
1000000000001
1111111111111
