1111111111
1010000001
1010000001
1010000001
1010000001
1000000001
1000000001
1000001001
1000001001
1111111111
