111111111111111111
101000000000000001
101000000000000001
101000000000000001
101000000000000001
1000000000000N0001
100000000000000001
100000100000000001
100000100000000001
111111111111111111
