NO ./textures/deneme0.xpm
SO ./textures/beer.xpm
WE ./textures/deneme2.xpm
EA ./textures/deneme1.xpm

F 220,100,0
C 225,30,0

1111111111111111111111111111111111111111111111111111111111111111111111111111111111111111111111111111111111111111111111111
1111N00000000000000000000000000010000000000000000000000000000000000000000000000000000000000000000000000000000011
1111000000000000000000000000000000000000000000000000000000000000000000000000000000000000000000000000000000000011
11111000000000000100000000000000000000000000000000000000000000000000000000000000000000000000000000000000000000011
11111000000000000100000000000000000000000000000000000000000000000000000000000000000000000000000000000000000000011
1111100000000000010000000000000000000000111111111111110000000000000000000000000000000000000000000000000000000000011
11111000000000000100000000000000000000000000000000000000000000000000000000000000000000000000000000000000000000011
11111000000000000100000000000000000000000000000000000000000000000000000000000000000000000000000000000000000000011
11111000000000000100000000000000000000000000000000000000000000000000000000000000000000000000000000000000000000011
1111100000000000010000000000000000000000000001111110000000000000000000000000000000000000000000000000000000000011
11111000000000000111111111110000000000000000000000000000000000000000000000000000000000000000000000000000000000011
111110000000000000000000000000000000000000000000000000000000000111111111100000000000000000000000000000000000000011
11111000000000000000000000000000000000000000000000000000000000000000000000000000000000000000000000000000000000011
11111000000000000000000000000000000000000000000000000000000000000000000000000000000000000000000000000000000000011
11111000000000000000000000000000000000000000000000000000000000000000000000000000000000000000000000000000000000011
1111100000000000000001111111000000000000000000000000000000000000000000000000000000000000000000000000000000000011
111000000000000000000000000000000000000000000000000000000000000000000000000000000000000000000000000000000000011
111000000000000000000000000000000000000000000000000000000000000000000000000000000000000000000000000000000000011
11000000000000000000000000000000000000000000000000000000000000000000000000000000000000000000000000000000000011
10000000000000000000000000000000000000000000000011111111111111111111111111111111111111111111111111111111111111
11111111111111111111111111111111111111111111111111111111111111111111
