NO ./textures/deneme0.xpm
SO ./textures/beer.xpm
WE ./textures/deneme2.xpm
EA ./textures/deneme3.xpm

F 220,100,0
C 225,30,0

1111111111111111111111111111111111111111111111111111
1000010000000000000000000000000000000000000000000001
1000010000000000000000000000000000000000000000000001
1000010000000000001111111111100000000000000000000001
1000010000000000000000000000000000000000000000000001
1000010000000000000000000000000000000000000000000001
1000010000000000000000000001011111111111111110000001
1000010000000000000000000000000000000000000000000001
1000010000000000000000000000000000000000000000000001
1000000000000000000000000000000000000000000000000001
1000000000000000000000000001000000000000000000000001
100000000000N000000000000000000000000000000000000001
1000000000000000000000000000000000000000000000000001
1000000000000000000000000000000000000000000000000001
1000000000000000000000111111111111111111000000000001
1000000000000000000000000000000000000000000000000001
1111111111111111111111111111111111111111111111111111
